000001111100000
001111000100000
001001000100000
111001100111111
100000000010000
111100000010000
000111111111100
111100001000110
000000001000010
000000111011110
111111100010000
001000100111100
001100111100100
000100000100100
000111000100000